00000010000-
00130000000-
02000021030-
02003000000-
00000002200-
00301102200-
00000000300