00000000000-
00002000000-
00002010300-
00010030000-
00003002000-
00100012000-
00000000000