00000000000-
00100001000-
00000201000-
00010200300-
00300200000-
00010003030-
00000000000