00000000000-
02203013000-
02200011000-
00000000000-
00110022030-
00300022000-
00000000000