00000000000-
00020000100-
00010030000-
00000002000-
00300002100-
00001000000-
00000000000