0000000000000-
0010000001000-
0000011000000-
0010011000000-
0000000001000-
0010001000000-
0000000000000