0000000000000-
0030111110300-
0000122210000-
0000122210000-
0000122210000-
0030111110300-
0000000000000