0000000000000-
0003300033000-
0001300031000-
0001002001000-
0001300031000-
0003300033000-
0000000000000