0000000000000-
0030000000300-
0000011100000-
0030011100300-
0000011100000-
0030000000300-
0000000000000