0000030000000-
0022000002000-
0000100302000-
0030000000000-
0000022010000-
0001000000300-
0000000000000