0000000000000-
0030122000000-
0000122003000-
0000000000000-
0003002210000-
0000002210300-
0000000000000