0000000000000-
0003300033000-
0001100011000-
0000002000000-
0001100011000-
0003300033000-
0000000000000