00000000000-
00330003300-
00110001100-
00000200000-
00110001100-
00330003300-
00000000000