0000000111000-
0022030131000-
0022000111000-
0000000000000-
0001100220300-
0003000220000-
0000000000000