0000000000000-
0000003000000-
0022001002200-
0022001002200-
0022001002200-
0000003000000-
0000000000000